111111111111111
100000000C00001
100001111100001
1P0011E00000001
100011000000001
100000000C00001
100000111110001
10000C000000001
100000000000001
111111111111111