11111111111111111111
10000C00000000000001
100000000011111000E1
100000000000001000C1
10000C000000001000C1
100000000000001000C1
100001111100000000C1
10000C000000000000C1
100000000000000000C1
100000111110000000C1
100000000010000000C1
100000000010000000C1
10000C000010000000C1
1000000000100P0000C1
100001111110000000C1
100000000000000000C1
100000000000000000C1
10000C000000000000C1
100000000000000000C1
11111111111111111111