1111111111111111111111111111111111111111
1P00C000000000C00000000000C000000000C001
1000000000000000000000000000000000000001
1000011111000001111100000111110000011111
1000000001000000000100000000010000000001
100000C001000C0000010C0000C0010C00000C01
1000000001000000000100000000010000000001
1111100001111100001111110000111110000001
1000000001000000001000000000100000000001
100C00C0010C000C001000C0C000100C00C00C01
1000000001000000001000000000100000000001
1000011111000001111000011111000011111001
1000010000000001000000010000000010000001
10C0010C000C0001000C00010C00C00010C00C01
1000010000000001000000010000000010000001
1000010000111111000011110001111110000001
1000010000100000000000000001000000000001
100001000010C000C00C000C0001000C00C00001
1000000000100000000000000001000000000001
1111111111111111111100111111111111111111
1000000000000000000000000000000000000001
100C000C000C000C000C000C000C000C000C0001
1000000000000000000000000000000000000001
1111100000111110000011111000001111100001
1000000000000000000000000000000000000001
100C000C000C000C000C000C000C000C000C0001
1000000000000000000000000000000000000001
1000011111000001111100000111110000011111
1000000001000000000100000000010000000001
100C000001000C0000010C0000C0010C000C0001
1000000001000000000100000000010000000001
1111100001111100001111110000111110000001
1000000001000000001000000000100000000001
100C00C0010C000C001000C0C000100C00C00C01
1000000001000000001000000000100000000001
1000011111000001111000011111000011111001
1000000000000000000000000000000000000001
100C000C000C000C000C000C000C000C000C00E1
1000000000000000000000000000000000000001
1111111111111111111111111111111111111111