1111111111111111111111111111111111111111111111111111111111111111111111111111111111
1000000000000000000000000000000000000000000000000000000000000000000000000000000001
1000000000000000000000000000000000000000000000000000000000000000000000000000000001
1000111111111111100000000000000000000000000000000000000000000000000000000000000001
1000100000000000100000000000000000000000000000000000000000000000000000000000000001
1000100000000000100000000000000000000000000000000000000000000000000000000000000001
1000100000P00000100000000000000000000000000000000000000000000000000000000000000001
1000100000000000100000000000000000000000000000000000000000000000000000000000000001
1000111111101111100000000000000000000000000000000000000000000000000000000000000001
1000000000101000000000000000000000000000000000000000000000000000000000000000000001
1000000000101111111111111111100000000000000000000000000000000000000000000000000001
1000000000100000000000000000100000000000000000000000000000000000000000000000000001
1000000000100000000000000000100000000000000000000000000000000000000000000000000001
1000000000100000000000000000100000000000000000000000000000000000000000000000000001
1000000000100000000000000000100000000000000000000000000000000000000000000000000001
1000000000111111111111111000100000000000000000000000000000000000000000000000000001
1000000000000000000000001000100000000000000000000000000000000000000000000000000001
1000000000000000000000001000100000000000000000000000000000000000000000000000000001
10000000000000000000000010001000000000000000000000C0000000000000000000000000000001
1000000000000000000000001000100000000000000000000000000000000000000000000000000001
1000000000000000000000001000100000000000000000000000000000000000000000000000000001
1000000000000000000000001000100000000000000000000000000000000000000000000000000001
1000000000000000000000001000100000000000000000000000000000000000000000000000000001
1000000000000000000000001000100000000000000000000000000000000000000000000000000001
1000000000000000000000001000100000000000000000000000000000000000000000000000000001
1000000000000000000000001000100000000000000000000000000000000000000000000000000001
1000000000000000000000001000100000000000000000000000000000000000000000000000000001
1000000000000000000000000000000000000000000000000000000000000000000000000000000001
1000000000000000000000000000000000000000000000000000000000000000000000000000000001
1000000000000000000000000000000000000000000000000000000000000000000000000000000001
1000000000000000000000000000000000000000000000000000C00000000000000000000000000001
1000000000000000000000000000000000000000000000000000000000000000000000000000000001
1000000000000000000000000000000000000000000000000000000000000000000000000000000001
1000000000000000000000000000000000000000000000000000000000000000000000000000000001
1000000000000000000000000000000000000000000000000000000000000000000000000000000001
1000000000000000000000000000000000000000000000C00000000000000000000000000000000001
1000000000000000000000000000000000000000000000000000000000000000000000000000000001
1000000000000000000000000000000000000000000000000000000000000000000000000000000001
1000000000000000000000000000000000000000000000000000000000000000000000000000000001
1000000000000000000000000000000000000000000000000000000000000000000000000000000001
1000000000000000000000000000000000000C00000000000000000000000000000000000000000001
1000000000000000000000000000000000000000000000000000000000000000000000000000000001
1000000000000000000000000000000000000000000000000000000000000000000000000000000001
1000000000000000000000000000000000000000000000000000000000000000000000000000000001
1000000000000000000000000000000000000000000000000000000000000000000000000000000001
1000000000000000000000000000000000000000000000000000000000000000000000000000000001
1000000000000000000000000000000000000000000000000000000000000000000000000000000001
1000000000000000000000000000000000000000000000000000000000000000000000000000000001
1000000000000000000000000000000000000000000000000000000000000000000000000000000001
100000000000000000000000000000000C000000000000000000000000000000000000000000000001
1000000000000000000000000000000000000000000000000000000000000000000000000000000001
1000000000000000000000000000000000000000000000000000000000000000000000000000000001
1000000000000000000000000000000000000000000000000000000000000000000000000000000001
1000000000000000000000000000000000000000000000000000000000000000000000000000000001
1000000000000000000000000000000000000000000000000000000000000000000000000000000001
1000000000000000000000000000000000000000000000000000000000000000000000000000000001
1000000000000000000011100000000000000000000000000000000000000000000000000000000001
1000000000000000000000000000000000000000000000000000000000000000000000000000000001
1000000000000000000000000000000000000000000000000000000000000000000000000000000001
1000000000000000000000011110000000000000000000000000000000000000000000000000000001
100000000000000000000000000000000000000C000000000000000000000000000000000000000001
1000000000000000000000000000000000000000000000000000000000000000000000000000000001
1000000000000000000000000000000000000000000000000000000000000000000000000000000001
1000000000000000000000000000000000000000000000000000000000000000000000000000000001
1000000000000000000000000000000000000000000000000000000000000000000000000000000001
1000000000000000000000000000000000000000000000000000000000000000000000000000000001
1000000000000000000000000000000000000000000000000000000000000000000000000000000001
100000000000000C0000000000000000000000000C0000000000000000000000000001111100000001
1000000000000000110000000000000000000000000000000000000000000000000000000000000001
1000000000000000000000000000000000000000000000000000000000000000000000000000000001
1000000000000000000000000000000000000001111111100000000000000000000000000000000001
10000000000000000000000000000000000000000000000000000000000000000000000000000000E1
1000000000111110000000000000000000000000000000000000000000000000000000000000000001
10000000C00000000000000000000C0000000000000000000000000000000000000000000000000001
1000000000000000000000000000000000000000000000000000000000C00000000000000000000001
1000000000000000000111111000000000000000000000000000000000000000000000000000000001
1000000000000000000000000000000000000000000000000000000000000000000000000000000001
1000000000000000000000000000000000000000000000000000000000000000000000000000000001
1111111111111111111111111111111111111110000000011111111111111111111111111111111111
1111111111111111111111111111111111111111100000001111111111111111111111111111111111
11111111111111111111111111111111111111111111000C1111111111111111111111111111111111
1111111111111111111111111111111111111111111111111111111111111111111111111111111111