111111111111111
100100000P0C001
100001111100001
1P0011E00000001
111111111111111