C111111111
10000000C1
1000011001
1P00000001
1000000001
1000C00001
1000000001
100000C001
1E00000001
1111111111