1111111111
10000000C1
1000011001
1000000001
1000000001
1111C00001
11P0001001
111101C101
1E00001001
1111111111