1111111111
10000000C1
1000011001
1000000001
1000000001
1111C00001
11P1000001
111100C001
1E00000001
1111111111